34 34 34 34 34 34 34 34 34 34 34 34 34 34 34 34 34 34 34 34 34 34 34 34 34 34 34 34 34 34 34 34 34 34 34 34 34 34 34 34 34 34 34 34 34 34 34 34 34 34 34 34 34 34 34 34 34 34 34 34 34 34 34 34 34 34 34 34
34 34 34 34 34 34 34 34 34 34 34 34 34 34 34 34 34 34 34 34 34 34 34 34 34 34 34 34 34 34 34 34 34 34 34 34 34 34 34 34 34 34 34 34 34 34 34 34 34 34 34 34 34 34 34 34 34 34 34 34 34 34 34 34 34 34 34 34
34 34 34 34 34 34 34 34 34 34 34 34 34 34 34 34 34 34 34 34 34 34 34 34 34 34 34 34 34 34 34 34 34 34 34 34 34 34 34 34 34 34 34 34 34 34 34 34 34 34 34 34 34 34 34 34 34 34 34 34 34 34 34 34 34 34 34 34
34 34 34 34 34 34 34 34 34 34 34 34 34 34 34 34 34 34 34 34 34 34 34 34 34 34 34 34 34 34 34 34 34 34 34 34 34 34 34 34 34 34 34 34 34 34 34 34 34 34 34 34 34 34 34 34 34 34 34 34 34 34 34 34 34 34 34 34
34 34 34 34 34 34 34 34 34 34 34 37 37 37 37 37 37 37 37 37 37 37 37 37 37 37 37 37 37 37 37 37 37 37 37 37 37 37 37 37 37 37 37 37 37 37 37 37 37 37 37 37 37 37 37 37 37 34 34 34 34 34 34 34 34 34 34 34
34 34 34 34 34 34 34 34 34 34 33 41 27 27 27 27 27 27 27 27 27 27 27 27 27 27 27 27 27 27 27 27 27 27 27 27 27 27 27 27 27 27 27 27 27 27 27 27 27 27 27 27 27 27 27 27 40 35 34 34 34 34 34 34 34 34 34 34
34 34 34 34 34 34 34 34 34 34 33 25 20 17 17 17 17 17 17 17 17 17 17 17 17 17 17 17 17 17 17 17 17 17 17 17 17 17 17 17 17 17 17 17 17 17 17 17 17 17 17 17 17 17 17 20 24 35 34 34 34 34 34 34 34 34 34 34
34 34 34 34 34 34 34 34 34 34 33 25 14 15 15 15 15 15 15 15 15 15 15 15 15 15 15 15 15 15 15 15 15 15 15 15 15 15 15 15 15 15 15 15 15 15 15 15 15 15 15 15 15 15 15 16 24 35 34 34 34 34 34 34 34 34 34 34
34 34 34 34 34 34 34 34 34 34 33 25 14 15 15 18 18 18 18 18 18 18 18 18 18 18 18 18 18 18 18 18 18 18 18 18 18 18 18 18 18 18 18 18 18 18 18 18 18 18 18 18 18 15 15 16 24 35 34 34 34 34 34 34 34 34 34 34
34 34 34 34 34 34 34 34 34 34 33 25 14 15 16 20 20 20 20 20 20 20 20 20 20 20 20 20 20 20 20 20 20 20 20 20 20 20 20 20 20 20 20 20 20 20 20 20 20 20 20 20 20 14 15 16 24 35 34 34 34 34 34 34 34 34 34 34
34 34 34 34 34 34 34 34 34 34 33 25 14 15 16 20 32 32 32 32 32 32 32 32 32 32 32 20 32 32 32 32 32 32 32 32 32 32 32 32 32 32 32 32 32 32 32 32 32 32 32 32 20 14 15 16 24 35 34 34 34 34 34 34 34 34 34 34
34 34 34 34 34 34 34 34 34 34 33 25 14 15 16 20 32 32 32 32 32 32 32 32 32 32 32 20 32 32 32 32 32 32 32 32 32 32 32 32 32 32 32 32 32 32 32 32 32 32 32 32 20 14 15 16 24 35 34 34 34 34 34 34 34 34 34 34
34 34 34 34 34 34 34 34 34 34 33 25 14 15 16 20 32 32 10 11 11 11 11 11 12 32 32 20 32 32 32 32 32 32 32 32 32 32 32 32 32 32 32 32 32 32 32 32 32 32 32 32 20 14 15 16 24 35 34 34 34 34 34 34 34 34 34 34
34 34 34 34 34 34 34 34 34 34 33 25 14 15 16 20 32 32 10 13 13 13 13 13 12 32 32 20 20 20 20 20 20 20 20 20 20 20 20 32 32 32 32 32 32 20 20 20 20 32 32 32 20 14 15 16 24 35 34 34 34 34 34 34 34 34 34 34
34 34 34 34 34 34 34 34 34 34 33 25 14 15 16 20 32 32 10 13 13 13 13 13 12 32 32 20 20 20 20 20 20 20 20 20 20 20 20 32 32 32 32 32 32 20 20 20 20 32 32 32 20 14 15 16 24 35 34 34 34 34 34 34 34 34 34 34
34 34 34 34 34 34 34 34 34 34 33 25 14 15 16 20 32 32 10 13 13 13 13 13 12 32 32 20 20 20 20 20 20 20 20 20 20 20 20 32 32 32 20 20 20 20 20 20 20 32 32 32 20 14 15 16 24 35 34 34 34 34 34 34 34 34 34 34
34 34 34 34 34 34 34 34 34 34 33 25 14 15 16 20 32 32 10 11 11 13 11 11 12 32 32 20 20 20 20 20 20 20 20 20 20 20 20 32 32 32 20 20 20 20 20 20 20 32 32 32 20 14 15 16 24 35 34 34 34 34 34 34 34 34 34 34
34 34 34 34 34 34 34 34 34 34 33 25 14 15 16 20 32 32 32 32 32 20 32 32 32 32 32 20 20 20 20 20 20 20 20 20 20 20 20 20 32 32 32 20 20 20 20 20 20 32 32 32 20 14 15 16 24 35 34 34 34 34 34 34 34 34 34 34
34 34 34 34 34 34 34 34 34 34 33 25 14 15 16 20 20 20 20 20 20 20 20 20 20 20 20 20 20 32 32 32 32 32 32 32 32 32 20 20 32 32 32 20 20 20 20 20 20 32 32 32 20 14 15 16 24 35 34 34 34 34 34 34 34 34 34 34
34 34 34 34 34 34 34 34 34 34 33 25 14 15 16 20 32 32 32 20 20 20 20 20 20 20 20 20 20 32 32 32 32 32 32 32 32 32 20 20 32 32 32 20 20 20 20 20 20 32 32 32 20 14 15 16 24 35 34 34 34 34 34 34 34 34 34 34
34 34 34 34 34 34 34 34 34 34 33 25 14 15 16 20 32 32 32 20 20 20 20 20 20 20 20 20 20 32 32 32 32 32 32 32 32 32 20 20 20 32 32 32 20 20 20 20 20 32 32 32 20 14 15 16 24 35 34 34 34 34 34 34 34 34 34 34
34 34 34 34 34 34 34 34 34 34 33 25 14 15 16 20 32 32 32 20 20 20 20 20 20 20 20 20 20 32 32 32 32 32 32 32 32 32 20 20 20 32 32 32 20 20 20 20 20 32 32 32 20 14 15 16 24 35 34 34 34 34 34 34 34 34 34 34
34 34 34 34 34 34 34 34 34 34 33 25 14 15 16 20 32 32 32 20 20 20 20 20 20 20 20 20 20 20 20 20 20 20 20 20 20 20 20 20 20 20 32 32 32 20 20 20 20 32 32 32 20 14 15 16 24 35 34 34 34 34 34 34 34 34 34 34
34 34 34 34 34 34 34 34 34 34 33 25 14 15 16 20 32 32 32 32 32 32 32 32 32 20 20 20 20 20 20 20 20 20 20 20 20 20 20 20 20 20 20 20 32 32 32 20 20 32 32 32 20 14 15 16 24 35 34 34 34 34 34 34 34 34 34 34
34 34 34 34 34 34 34 34 34 34 33 25 14 15 16 20 32 32 32 32 32 32 32 32 32 20 20 20 20 20 20 20 20 20 20 20 20 20 20 20 20 20 20 20 20 20 20 20 20 32 32 32 20 14 15 16 24 35 34 34 34 34 34 34 34 34 34 34
34 34 34 34 34 34 34 34 34 34 33 25 14 15 16 20 32 32 32 32 32 32 32 32 32 20 20 20 20 20 20 20 20 20 20 20 20 20 20 20 20 20 20 20 20 20 20 20 20 20 20 20 20 14 15 16 24 35 34 34 34 34 34 34 34 34 34 34
34 34 34 34 34 34 34 34 34 34 33 25 14 15 16 20 20 20 20 20 20 20 20 20 20 20 20 20 20 20 20 20 20 20 20 20 32 32 32 32 32 32 32 32 32 32 32 32 20 32 32 32 20 14 15 16 24 35 34 34 34 34 34 34 34 34 34 34
34 34 34 34 34 34 34 34 34 34 33 25 14 15 16 20 32 32 32 32 20 32 32 32 32 32 32 32 32 32 32 32 32 32 20 20 32 32 32 32 32 32 32 32 32 32 32 32 20 32 32 32 20 14 15 16 24 35 34 34 34 34 34 34 34 34 34 34
34 34 34 34 34 34 34 34 34 34 33 25 14 15 16 20 32 32 32 32 20 32 32 32 32 32 32 32 32 32 32 32 32 32 20 20 32 32 32 32 32 32 32 32 32 32 32 32 20 32 32 32 20 14 15 16 24 35 34 34 34 34 34 34 34 34 34 34
34 34 34 34 34 34 34 34 34 34 33 25 14 15 16 20 32 32 32 32 20 32 32 32 32 32 32 32 32 32 32 32 32 32 20 20 20 20 20 20 20 20 20 20 20 20 20 20 20 20 20 20 20 14 15 16 24 35 34 34 34 34 34 34 34 34 34 34
34 34 34 34 34 34 34 34 34 34 33 25 14 15 16 20 32 32 32 10 13 11 11 11 11 11 11 11 11 11 12 32 32 32 20 20 20 20 20 20 20 20 20 20 20 20 20 20 20 32 32 32 20 14 15 16 24 35 34 34 34 34 34 34 34 34 34 34
34 34 34 34 34 34 34 34 34 34 33 25 14 15 16 20 32 32 32 10 13 13 13 13 13 13 13 13 13 13 12 32 32 32 20 20 20 20 20 20 20 20 20 20 20 20 20 20 20 32 32 32 20 14 15 16 24 35 34 34 34 34 34 34 34 34 34 34
34 34 34 34 34 34 34 34 34 34 33 25 14 15 16 20 32 32 32 10 13 13 13 13 13 13 13 13 13 13 12 32 32 32 20 20 20 20 20 20 20 20 20 20 20 20 20 20 20 32 32 32 20 14 15 16 24 35 34 34 34 34 34 34 34 34 34 34
34 34 34 34 34 34 34 34 34 34 33 25 14 15 16 20 32 32 32 10 13 13 13 13 13 13 13 13 13 13 13 20 20 20 20 20 20 20 20 20 32 32 32 32 32 32 32 32 32 32 32 32 20 14 15 16 24 35 34 34 34 34 34 34 34 34 34 34
34 34 34 34 34 34 34 34 34 34 33 25 14 15 16 20 32 32 32 10 13 13 13 13 13 13 13 13 13 13 12 32 32 32 20 20 20 20 20 20 32 32 32 32 32 32 32 32 32 32 32 32 20 14 15 16 24 35 34 34 34 34 34 34 34 34 34 34
34 34 34 34 34 34 34 34 34 34 33 25 14 15 16 20 20 20 20 13 13 13 13 13 13 13 13 13 13 13 12 32 32 32 20 20 20 20 20 20 20 20 20 20 20 20 20 20 20 20 32 32 20 14 15 16 24 35 34 34 34 34 34 34 34 34 34 34
34 34 34 34 34 34 34 34 34 34 33 25 14 15 16 20 32 32 32 10 11 11 11 11 11 11 11 11 11 11 12 32 32 32 20 20 20 20 20 20 20 20 20 20 20 20 20 20 20 20 32 32 20 14 15 16 24 35 34 34 34 34 34 34 34 34 34 34
34 34 34 34 34 34 34 34 34 34 33 25 14 15 16 20 32 32 32 32 32 32 32 32 32 32 32 32 32 32 32 32 32 32 32 32 32 32 32 32 32 32 32 32 32 32 32 32 32 32 32 32 20 14 15 16 24 35 34 34 34 34 34 34 34 34 34 34
34 34 34 34 34 34 34 34 34 34 33 25 14 15 16 20 32 32 32 32 32 32 32 32 32 32 32 32 32 32 32 32 32 32 32 32 32 32 32 32 32 32 32 32 32 32 32 32 32 32 32 32 20 14 15 16 24 35 34 34 34 34 34 34 34 34 34 34
34 34 34 34 34 34 34 34 34 34 33 25 14 15 16 20 32 32 32 32 32 32 32 32 32 32 32 32 32 32 32 32 32 32 32 32 32 32 32 32 32 32 32 32 32 32 32 32 32 32 32 32 20 14 15 16 24 35 34 34 34 34 34 34 34 34 34 34
34 34 34 34 34 34 34 34 34 34 33 25 14 15 16 20 20 20 20 20 20 20 20 20 20 20 20 20 20 20 20 20 20 20 20 20 20 20 20 20 20 20 20 20 20 20 20 20 20 20 20 20 20 14 15 16 24 35 34 34 34 34 34 34 34 34 34 34
34 34 34 34 34 34 34 34 34 34 33 25 14 15 15 17 17 17 17 17 17 17 17 17 17 17 17 17 17 17 17 17 17 17 17 17 17 17 17 17 17 17 17 17 17 17 17 17 17 17 17 17 17 15 15 16 24 35 34 34 34 34 34 34 34 34 34 34
34 34 34 34 34 34 34 34 34 34 33 25 14 15 15 15 15 15 15 15 15 15 15 15 15 15 15 15 15 15 15 15 15 15 15 15 15 15 15 15 15 15 15 15 15 15 15 15 15 15 15 15 15 15 15 16 24 35 34 34 34 34 34 34 34 34 34 34
34 34 34 34 34 34 34 34 34 34 33 25 20 18 18 18 18 18 18 18 18 18 18 18 18 18 18 18 18 18 18 18 18 18 18 18 18 18 18 18 18 18 18 18 18 18 18 18 18 18 18 18 18 18 18 20 24 35 34 34 34 34 34 34 34 34 34 34
34 34 34 34 34 34 34 34 34 34 33 39 26 26 26 26 26 26 26 26 26 26 26 26 26 26 26 26 26 26 26 26 26 26 26 26 26 26 26 26 26 26 26 26 26 26 26 26 26 26 26 26 26 26 26 26 38 35 34 34 34 34 34 34 34 34 34 34
34 34 34 34 34 34 34 34 34 34 34 36 36 36 36 36 36 36 36 36 36 36 36 36 36 36 36 36 36 36 36 36 36 36 36 36 36 36 36 36 36 36 36 36 36 36 36 36 36 36 36 36 36 36 36 36 36 34 34 34 34 34 34 34 34 34 34 34
34 34 34 34 34 34 34 34 34 34 34 34 34 34 34 34 34 34 34 34 34 34 34 34 34 34 34 34 34 34 34 34 34 34 34 34 34 34 34 34 34 34 34 34 34 34 34 34 34 34 34 34 34 34 34 34 34 34 34 34 34 34 34 34 34 34 34 34
34 34 34 34 34 34 34 34 34 34 34 34 34 34 34 34 34 34 34 34 34 34 34 34 34 34 34 34 34 34 34 34 34 34 34 34 34 34 34 34 34 34 34 34 34 34 34 34 34 34 34 34 34 34 34 34 34 34 34 34 34 34 34 34 34 34 34 34
34 34 34 34 34 34 34 34 34 34 34 34 34 34 34 34 34 34 34 34 34 34 34 34 34 34 34 34 34 34 34 34 34 34 34 34 34 34 34 34 34 34 34 34 34 34 34 34 34 34 34 34 34 34 34 34 34 34 34 34 34 34 34 34 34 34 34 34
34 34 34 34 34 34 34 34 34 34 34 34 34 34 34 34 34 34 34 34 34 34 34 34 34 34 34 34 34 34 34 34 34 34 34 34 34 34 34 34 34 34 34 34 34 34 34 34 34 34 34 34 34 34 34 34 34 34 34 34 34 34 34 34 34 34 34 34
